.........................
. M. b.           .     .
.  .  .  .  ....  ....  .
.  .     .  .           .
.  .............  .......
.        A           .  .
.  ....  .  ..........  .
.  . a.  .              .
....  ..........  .......
.  .           .       +.
.  ....  ....  .  .  ....
.  .     .     .  .  .  .
.  ....  .  ..........  .
.     .  .           .  .
.  ....  .  ..........  .
.L       .       B     -.
.........................