...............................
.   c.     .         .      .+.
.A.  .  .  .B.    .  .  .....E.
.M.     .    .    .     .     .
................  ....  .  ....
.a      .      .     .       d.
....  .C.   ...................
.     .           .     .e    .
.  .............  ....  ....  .
.     .     .b    D           .
.  ....  ..........  ..........
.L    .        .             -.
...............................