................................................
.    M                   a           B        +.
................................................
.       L                    A           b    -.
................................................