.........................
. M.b.           .     +.
.  .A.  .   ...  ....   .
.       .   .           .
.........................
.    a.  .           .  .
.  ....  B  ..........  .
.L       .             -.
.........................