 __                                      __          __   
/  |                                    /  |       _/  |  
$$ |        ______   __     __  ______  $$ |      / $$ |  
$$ |       /      \ /  \   /  |/      \ $$ |      $$$$ |  
$$ |      /$$$$$$  |$$  \ /$$//$$$$$$  |$$ |        $$ |  
$$ |      $$    $$ | $$  /$$/ $$    $$ |$$ |        $$ |  
$$ |_____ $$$$$$$$/   $$ $$/  $$$$$$$$/ $$ |       _$$ |_ 
$$       |$$       |   $$$/   $$       |$$ |      / $$   |
$$$$$$$$/  $$$$$$$/     $/     $$$$$$$/ $$/       $$$$$$/ 