 __                                      __         ______  
/  |                                    /  |       /      \ 
$$ |        ______   __     __  ______  $$ |      /$$$$$$  |
$$ |       /      \ /  \   /  |/      \ $$ |      $$____$$ |
$$ |      /$$$$$$  |$$  \ /$$//$$$$$$  |$$ |       /    $$/ 
$$ |      $$    $$ | $$  /$$/ $$    $$ |$$ |      /$$$$$$/  
$$ |_____ $$$$$$$$/   $$ $$/  $$$$$$$$/ $$ |      $$ |_____ 
$$       |$$       |   $$$/   $$       |$$ |      $$       |
$$$$$$$$/  $$$$$$$/     $/     $$$$$$$/ $$/       $$$$$$$$/ 
                                                           