 __                                      __        __    __ 
/  |                                    /  |      /  |  /  |
$$ |        ______   __     __  ______  $$ |      $$ |  $$ |
$$ |       /      \ /  \   /  |/      \ $$ |      $$ |__$$ |
$$ |      /$$$$$$  |$$  \ /$$//$$$$$$  |$$ |      $$    $$ |
$$ |      $$    $$ | $$  /$$/ $$    $$ |$$ |      $$$$$$$$ |
$$ |_____ $$$$$$$$/   $$ $$/  $$$$$$$$/ $$ |            $$ |
$$       |$$       |   $$$/   $$       |$$ |            $$ |
$$$$$$$$/  $$$$$$$/     $/     $$$$$$$/ $$/             $$/ 