................................................
.    M                   a           B        +.
................................................
.                           .            b     .
.                           .                  .
.       L                   A                 -.
................................................